E,E,E,E,E,E,E,W,E,C
E,E,E,E,E,E,E,E,E,E
E,E,E,E,E,E,E,W,W,W
E,E,E,E,E,E,E,E,E,E
E,E,E,E,W,W,W,W,E,E
E,E,E,E,E,E,E,E,E,E
E,E,E,E,E,E,E,E,E,E
W,W,W,E,E,E,W,E,E,E
E,E,E,E,E,E,W,E,E,E
M,E,E,E,E,E,W,E,E,E