E,E,E,C,E
E,E,E,W,W
W,W,E,E,E
E,E,W,W,E
M,E,E,E,E