E,E,E,C,E
E,W,E,W,W
E,W,E,E,E
E,E,W,W,E
M,E,E,E,E