E,E,E,W,C
E,W,E,W,E
E,W,E,W,E
E,W,E,W,E
M,W,E,E,E